11111111111111111111
00000000000000000001
00000000000000000001
0000000000N000000001
00000000002000000001
11111111111111111111